巴黎	PAR	Paris	法国
罗马	ROM	Rome	意大利
威尼斯	VCE	Venice	意大利
佛罗伦萨	FLR	Florence	意大利
米兰	MIL	Milan	意大利
巴塞罗那	BCN	Barcelona	西班牙
阿姆斯特丹	AMS	Amsterdam	荷兰
慕尼黑	MUC	Munich	德国
伦敦	LON	London	英国
维也纳	VIE	Vienna	奥地利
布拉格	PRG	Prague	捷克
柏林	BER	Berlin	德国
法兰克福	FRA	Frankfurt	德国
尼斯	NCE	Nice	法国
布鲁塞尔	BRU	Brussels	比利时
马德里	MAD	Madrid	西班牙
比萨	PSA	Pisa	意大利
苏黎世	ZRH	Zurich	瑞士
日内瓦	GVA	Geneva	瑞士
科隆	CGN	Cologne	德国
凡尔赛	NULL	Versailles	法国
萨尔茨堡	SZG	Salzburg	奥地利
斯德哥尔摩	STO	Stockholm	瑞典
爱丁堡	EDI	Edinburgh	英国
布达佩斯	BUD	Budapest	匈牙利
哥本哈根	CPH	Copenhagen	丹麦
海德堡	HDB	Heidelberg	德国
牛津	OXF	Oxford	英国
伯尔尼	BRN	Bern	瑞士
卢森堡	LUX	Luxembourg City	卢森堡
塞维利亚	SVQ	Seville	西班牙
汉堡	HAM	Hamburg	德国
鹿特丹	RTM	Rotterdam	荷兰
里斯本	LIS	Lisbon	葡萄牙
曼彻斯特	MAN	Manchester	英国
马赛	MRS	Marseille	法国
赫尔辛基	HEL	Helsinki	芬兰
里昂	LYS	Lyon	法国
奥斯陆	OSL	Oslo	挪威
维罗纳	VRN	Verona	意大利
杜塞尔多夫	DUS	Dusseldorf	德国
那不勒斯	NAP	Naples	意大利
因斯布鲁克	INN	Innsbruck	奥地利
斯图加特	STR	Stuttgart	德国
格拉纳达	GRX	Granada	西班牙
伯明翰	BHX	Birmingham	英国
安特卫普	ANR	Antwerp	比利时
格拉斯哥	GLA	Glasgow	英国
巴塞尔	BSL	Basel	瑞士
波恩	BNJ	Bonn	德国
卑尔根	BGO	Bergen	挪威
利物浦	LPL	Liverpool	英国
枫丹白露	NULL	Fontainebleau	法国
纽伦堡	NUE	Nuremberg	德国
斯特拉斯堡	SXB	Strasbourg	法国
波尔图	OPO	Porto	葡萄牙
瓦伦西亚	VLC	Valencia	西班牙
华沙	WAW	Warsaw	波兰
波尔多	BOD	Bordeaux	法国
汉诺威	HAJ	Hannover	德国
热那亚	GOA	Genova	意大利
博洛尼亚	BLQ	Bologna	意大利
不来梅	BRE	Bremen	德国
哥德堡	GOT	Goteborg	瑞典
利兹	LBA	Leeds	英国
布里斯托尔	BRS	Bristol	英国
亚琛	AAH	Aachen	德国
马尔默	MMA	Malmo	瑞典
马拉加	AGP	Malaga	西班牙
卢加诺	LUG	Lugano	瑞士
诺丁汉	NQT	Nottingham	英国
尼姆	FNI	Nimes	法国
卡罗维发利	KLV	Karlovy Vary	捷克
莱比锡	LEJ	Leipzig	德国
都灵	TRN	Turin	意大利
纽卡斯尔	NCL	Newcastle	英国
贝尔法斯特	BFS	Belfast	英国
